#SampleID	BarcodeSequence	LinkerPrimerSequence	Description
G01.psbA.trnJ.R	ACGAGTGCGT	CGCGCATGGTGGATTCACAATCC	Splat
G02.psbA.trnJ.R	ACGCTCGACA	CGCGCATGGTGGATTCACAATCC	Splat
G03.psbA.trnJ.R	AGACGCACTC	CGCGCATGGTGGATTCACAATCC	Splat
G04.psbA.trnJ.R	AGCACTGTAG	CGCGCATGGTGGATTCACAATCC	Splat
G05.psbA.trnJ.R	ATCAGACACG	CGCGCATGGTGGATTCACAATCC	Splat
G06.psbA.trnJ.R	ATATCGCGAG	CGCGCATGGTGGATTCACAATCC	Pollen-Swab
G07.psbA.trnJ.R	CGTGTCTCTA	CGCGCATGGTGGATTCACAATCC	Pollen-Swab
G08.psbA.trnJ.R	CTCGCGTGTC	CGCGCATGGTGGATTCACAATCC	Pollen-Swab
G09.psbA.trnJ.R	TCTCTATGCG	CGCGCATGGTGGATTCACAATCC	Pollen-Swab
G10.psbA.trnJ.R	TGATACGTCT	CGCGCATGGTGGATTCACAATCC	Pollen-Swab
G11.psbA.trnJ.R	CATAGTAGTG	CGCGCATGGTGGATTCACAATCC	Pollen-Swab
G12.psbA.trnJ.R	CGAGAGATAC	CGCGCATGGTGGATTCACAATCC	Pollen-Swab
G13.psbA.trnJ.R	ATACGACGTA	CGCGCATGGTGGATTCACAATCC	Pollen-Swab
G14.psbA.trnJ.R	TCACGTACTA	CGCGCATGGTGGATTCACAATCC	Pollen-Swab
G15.psbA.trnJ.R	CGTCTAGTAC	CGCGCATGGTGGATTCACAATCC	Pollen-Swab
G16.psbA.trnJ.R	TCTACGTAGC	CGCGCATGGTGGATTCACAATCC	Pollen-Swab
G17.psbA.trnJ.R	TGTACTACTC	CGCGCATGGTGGATTCACAATCC	Pollen-Swab
G18.psbA.trnJ.R	ACGACTACAG	CGCGCATGGTGGATTCACAATCC	Pollen-Swab
G19.psbA.trnJ.R	CGTAGACTAG	CGCGCATGGTGGATTCACAATCC	Pollen-Swab
G20.psbA.trnJ.R	TACGAGTATG	CGCGCATGGTGGATTCACAATCC	Pollen-Swab
G21.psbA.trnJ.R	TACTCTCGTG	CGCGCATGGTGGATTCACAATCC	Pollen-Swab
G22.psbA.trnJ.R	TAGAGACGAG	CGCGCATGGTGGATTCACAATCC	Pollen-Swab
G23.psbA.trnJ.R	TCGTCGCTCG	CGCGCATGGTGGATTCACAATCC	Pollen-Swab
G24.psbA.trnJ.R	ACATACGCGT	CGCGCATGGTGGATTCACAATCC	Pollen-Swab
G25.psbA.trnJ.R	ACGCGAGTAT	CGCGCATGGTGGATTCACAATCC	Pollen-Swab
G26.psbA.trnJ.R	ACTACTATGT	CGCGCATGGTGGATTCACAATCC	Pollen-Swab
G27.psbA.trnJ.R	ACTGTACAGT	CGCGCATGGTGGATTCACAATCC	Pollen-Swab
G28.psbA.trnJ.R	AGACTATACT	CGCGCATGGTGGATTCACAATCC	Pollen-Swab
G29.psbA.trnJ.R	AGCGTCGTCT	CGCGCATGGTGGATTCACAATCC	Pollen-Swab
G30.psbA.trnJ.R	AGTACGCTAT	CGCGCATGGTGGATTCACAATCC	Pollen-Swab
G31.psbA.trnJ.R	CAGTAGACGT	CGCGCATGGTGGATTCACAATCC	Pollen-Swab
G32.psbA.trnJ.R	CGACGTGACT	CGCGCATGGTGGATTCACAATCC	Pollen-Swab
G33.psbA.trnJ.R	TACACACACT	CGCGCATGGTGGATTCACAATCC	Pollen-Swab
G34.psbA.trnJ.R	TACACGTGAT	CGCGCATGGTGGATTCACAATCC	Pollen-Swab
G35.psbA.trnJ.R	TACAGATCGT	CGCGCATGGTGGATTCACAATCC	Pollen-Swab
G36.psbA.trnJ.R	TAGTGTAGAT	CGCGCATGGTGGATTCACAATCC	Pollen-Swab
G37.psbA.trnJ.R	TCGATCACGT	CGCGCATGGTGGATTCACAATCC	Pollen-Swab
G38.psbA.trnJ.R	TCGCACTAGT	CGCGCATGGTGGATTCACAATCC	Pollen-Swab
G39.psbA.trnJ.R	TCTAGCGACT	CGCGCATGGTGGATTCACAATCC	Pollen-Swab
G40.psbA.trnJ.R	TCTATACTAT	CGCGCATGGTGGATTCACAATCC	Pollen-Swab
G41.psbA.trnJ.R	TGACGTATGT	CGCGCATGGTGGATTCACAATCC	Pollen-Swab
G42.psbA.trnJ.R	TGTGAGTAGT	CGCGCATGGTGGATTCACAATCC	Pollen-Swab