#SampleID	BarcodeSequence	LinkerPrimerSequence	Description
G01.rbcLa.R	ACGAGTGCGT	CTTCTGCTACAAATAAGAATCGATCTC	Splat
G02.rbcLa.R	ACGCTCGACA	CTTCTGCTACAAATAAGAATCGATCTC	Splat
G03.rbcLa.R	AGACGCACTC	CTTCTGCTACAAATAAGAATCGATCTC	Splat
G04.rbcLa.R	AGCACTGTAG	CTTCTGCTACAAATAAGAATCGATCTC	Splat
G05.rbcLa.R	ATCAGACACG	CTTCTGCTACAAATAAGAATCGATCTC	Splat
G06.rbcLa.R	ATATCGCGAG	CTTCTGCTACAAATAAGAATCGATCTC	Pollen-Swab
G07.rbcLa.R	CGTGTCTCTA	CTTCTGCTACAAATAAGAATCGATCTC	Pollen-Swab
G08.rbcLa.R	CTCGCGTGTC	CTTCTGCTACAAATAAGAATCGATCTC	Pollen-Swab
G09.rbcLa.R	TCTCTATGCG	CTTCTGCTACAAATAAGAATCGATCTC	Pollen-Swab
G10.rbcLa.R	TGATACGTCT	CTTCTGCTACAAATAAGAATCGATCTC	Pollen-Swab
G11.rbcLa.R	CATAGTAGTG	CTTCTGCTACAAATAAGAATCGATCTC	Pollen-Swab
G12.rbcLa.R	CGAGAGATAC	CTTCTGCTACAAATAAGAATCGATCTC	Pollen-Swab
G13.rbcLa.R	ATACGACGTA	CTTCTGCTACAAATAAGAATCGATCTC	Pollen-Swab
G14.rbcLa.R	TCACGTACTA	CTTCTGCTACAAATAAGAATCGATCTC	Pollen-Swab
G15.rbcLa.R	CGTCTAGTAC	CTTCTGCTACAAATAAGAATCGATCTC	Pollen-Swab
G16.rbcLa.R	TCTACGTAGC	CTTCTGCTACAAATAAGAATCGATCTC	Pollen-Swab
G17.rbcLa.R	TGTACTACTC	CTTCTGCTACAAATAAGAATCGATCTC	Pollen-Swab
G18.rbcLa.R	ACGACTACAG	CTTCTGCTACAAATAAGAATCGATCTC	Pollen-Swab
G19.rbcLa.R	CGTAGACTAG	CTTCTGCTACAAATAAGAATCGATCTC	Pollen-Swab
G20.rbcLa.R	TACGAGTATG	CTTCTGCTACAAATAAGAATCGATCTC	Pollen-Swab
G21.rbcLa.R	TACTCTCGTG	CTTCTGCTACAAATAAGAATCGATCTC	Pollen-Swab
G22.rbcLa.R	TAGAGACGAG	CTTCTGCTACAAATAAGAATCGATCTC	Pollen-Swab
G23.rbcLa.R	TCGTCGCTCG	CTTCTGCTACAAATAAGAATCGATCTC	Pollen-Swab
G24.rbcLa.R	ACATACGCGT	CTTCTGCTACAAATAAGAATCGATCTC	Pollen-Swab
G25.rbcLa.R	ACGCGAGTAT	CTTCTGCTACAAATAAGAATCGATCTC	Pollen-Swab
G26.rbcLa.R	ACTACTATGT	CTTCTGCTACAAATAAGAATCGATCTC	Pollen-Swab
G27.rbcLa.R	ACTGTACAGT	CTTCTGCTACAAATAAGAATCGATCTC	Pollen-Swab
G28.rbcLa.R	AGACTATACT	CTTCTGCTACAAATAAGAATCGATCTC	Pollen-Swab
G29.rbcLa.R	AGCGTCGTCT	CTTCTGCTACAAATAAGAATCGATCTC	Pollen-Swab
G30.rbcLa.R	AGTACGCTAT	CTTCTGCTACAAATAAGAATCGATCTC	Pollen-Swab
G31.rbcLa.R	CAGTAGACGT	CTTCTGCTACAAATAAGAATCGATCTC	Pollen-Swab
G32.rbcLa.R	CGACGTGACT	CTTCTGCTACAAATAAGAATCGATCTC	Pollen-Swab
G33.rbcLa.R	TACACACACT	CTTCTGCTACAAATAAGAATCGATCTC	Pollen-Swab
G34.rbcLa.R	TACACGTGAT	CTTCTGCTACAAATAAGAATCGATCTC	Pollen-Swab
G35.rbcLa.R	TACAGATCGT	CTTCTGCTACAAATAAGAATCGATCTC	Pollen-Swab
G36.rbcLa.R	TAGTGTAGAT	CTTCTGCTACAAATAAGAATCGATCTC	Pollen-Swab
G37.rbcLa.R	TCGATCACGT	CTTCTGCTACAAATAAGAATCGATCTC	Pollen-Swab
G38.rbcLa.R	TCGCACTAGT	CTTCTGCTACAAATAAGAATCGATCTC	Pollen-Swab
G39.rbcLa.R	TCTAGCGACT	CTTCTGCTACAAATAAGAATCGATCTC	Pollen-Swab
G40.rbcLa.R	TCTATACTAT	CTTCTGCTACAAATAAGAATCGATCTC	Pollen-Swab
G41.rbcLa.R	TGACGTATGT	CTTCTGCTACAAATAAGAATCGATCTC	Pollen-Swab
G42.rbcLa.R	TGTGAGTAGT	CTTCTGCTACAAATAAGAATCGATCTC	Pollen-Swab