#SampleID	BarcodeSequence	LinkerPrimerSequence	Description
G01.trnL.R	ACGAGTGCGT	CGGGATAGAGGGACTTGAAC	Splat
G02.trnL.R	ACGCTCGACA	CGGGATAGAGGGACTTGAAC	Splat
G03.trnL.R	AGACGCACTC	CGGGATAGAGGGACTTGAAC	Splat
G04.trnL.R	AGCACTGTAG	CGGGATAGAGGGACTTGAAC	Splat
G05.trnL.R	ATCAGACACG	CGGGATAGAGGGACTTGAAC	Splat
G06.trnL.R	ATATCGCGAG	CGGGATAGAGGGACTTGAAC	Pollen-Swab
G07.trnL.R	CGTGTCTCTA	CGGGATAGAGGGACTTGAAC	Pollen-Swab
G08.trnL.R	CTCGCGTGTC	CGGGATAGAGGGACTTGAAC	Pollen-Swab
G09.trnL.R	TCTCTATGCG	CGGGATAGAGGGACTTGAAC	Pollen-Swab
G10.trnL.R	TGATACGTCT	CGGGATAGAGGGACTTGAAC	Pollen-Swab
G11.trnL.R	CATAGTAGTG	CGGGATAGAGGGACTTGAAC	Pollen-Swab
G12.trnL.R	CGAGAGATAC	CGGGATAGAGGGACTTGAAC	Pollen-Swab
G13.trnL.R	ATACGACGTA	CGGGATAGAGGGACTTGAAC	Pollen-Swab
G14.trnL.R	TCACGTACTA	CGGGATAGAGGGACTTGAAC	Pollen-Swab
G15.trnL.R	CGTCTAGTAC	CGGGATAGAGGGACTTGAAC	Pollen-Swab
G16.trnL.R	TCTACGTAGC	CGGGATAGAGGGACTTGAAC	Pollen-Swab
G17.trnL.R	TGTACTACTC	CGGGATAGAGGGACTTGAAC	Pollen-Swab
G18.trnL.R	ACGACTACAG	CGGGATAGAGGGACTTGAAC	Pollen-Swab
G19.trnL.R	CGTAGACTAG	CGGGATAGAGGGACTTGAAC	Pollen-Swab
G20.trnL.R	TACGAGTATG	CGGGATAGAGGGACTTGAAC	Pollen-Swab
G21.trnL.R	TACTCTCGTG	CGGGATAGAGGGACTTGAAC	Pollen-Swab
G22.trnL.R	TAGAGACGAG	CGGGATAGAGGGACTTGAAC	Pollen-Swab
G23.trnL.R	TCGTCGCTCG	CGGGATAGAGGGACTTGAAC	Pollen-Swab
G24.trnL.R	ACATACGCGT	CGGGATAGAGGGACTTGAAC	Pollen-Swab
G25.trnL.R	ACGCGAGTAT	CGGGATAGAGGGACTTGAAC	Pollen-Swab
G26.trnL.R	ACTACTATGT	CGGGATAGAGGGACTTGAAC	Pollen-Swab
G27.trnL.R	ACTGTACAGT	CGGGATAGAGGGACTTGAAC	Pollen-Swab
G28.trnL.R	AGACTATACT	CGGGATAGAGGGACTTGAAC	Pollen-Swab
G29.trnL.R	AGCGTCGTCT	CGGGATAGAGGGACTTGAAC	Pollen-Swab
G30.trnL.R	AGTACGCTAT	CGGGATAGAGGGACTTGAAC	Pollen-Swab
G31.trnL.R	CAGTAGACGT	CGGGATAGAGGGACTTGAAC	Pollen-Swab
G32.trnL.R	CGACGTGACT	CGGGATAGAGGGACTTGAAC	Pollen-Swab
G33.trnL.R	TACACACACT	CGGGATAGAGGGACTTGAAC	Pollen-Swab
G34.trnL.R	TACACGTGAT	CGGGATAGAGGGACTTGAAC	Pollen-Swab
G35.trnL.R	TACAGATCGT	CGGGATAGAGGGACTTGAAC	Pollen-Swab
G36.trnL.R	TAGTGTAGAT	CGGGATAGAGGGACTTGAAC	Pollen-Swab
G37.trnL.R	TCGATCACGT	CGGGATAGAGGGACTTGAAC	Pollen-Swab
G38.trnL.R	TCGCACTAGT	CGGGATAGAGGGACTTGAAC	Pollen-Swab
G39.trnL.R	TCTAGCGACT	CGGGATAGAGGGACTTGAAC	Pollen-Swab
G40.trnL.R	TCTATACTAT	CGGGATAGAGGGACTTGAAC	Pollen-Swab
G41.trnL.R	TGACGTATGT	CGGGATAGAGGGACTTGAAC	Pollen-Swab
G42.trnL.R	TGTGAGTAGT	CGGGATAGAGGGACTTGAAC	Pollen-Swab